R 800 600
NO   ./textures/NO.xpm 
SO   ./textures/SO.xpm 
WE   ./textures/WE.xpm 
EA ./textures/EA.xpm 
S ./textures/SPRITE.xpm
C 0     ,  0     ,   0 
F 255   ,   255   ,   255

              11111
              10001
              10001
              11111
11111111111111111111111111111111111
1S000000000000000000000000000001111
11111000111111100011000111111000111
    10001     100011000111111000111 
    10001     100011000000000001111
    10001     100011000000000001111
    10001     100011000111111000111
    10001     100011000111111000111
    10001     100011000000000000111
    11111     111111111111111111111
