R 800 600
NO   ./textures/NO.xpm 
SO   ./textures/SO.xpm 
WE   ./textures/WE.xpm 
EA ./textures/EA.xpm 
S ./textures/SPRITE.xpm
F 0,0,0
C 255,255,255

111111111
100000N01
111111111
