R 800 600
NO   ./textures/NO.xpm 
SO   ./textures/SO.xpm 
WE   ./textures/WE.xpm 
EA ./textures/EA.xpm 
S ./textures/SPRITE.xpm
C 0     ,  0     ,   0 
F 255   ,   255   ,   255

111111
110011
100001
100001
1000N1
111111
