R 800 600
NO   ./textures/NO.xpm 
SO   ./textures/SO.xpm 
WE   ./textures/WE.xpm 
EA ./textures/EA.xpm 
S ./textures/SPRITE.xpm
C 200     ,  200     ,   -2999999999999999999999999 
F 100   ,   155   ,  255

111111111111111
100000000000001
100222222222001
100000000000001
100000W00000001
100000000000001
100000000000001
100000000000001
111111111111111
