R 800 600
NO   ./source/save.c 
SO   ./textures/SO.xpm 
WE   ./textures/WE.xpm 
EA ./textures/EA.xpm 
S ./textures/SPRITE.xpm
C 200     ,  200     ,   29 
F 100   ,   155   ,  255

111111111111111
100000000000001
100222222222001
100000000000001
100000W00000001
100000000000001
100000000000001
100000000000001
111111111111111
