R 800 600
NO   ./textures/NO.xpm 
SO   ./textures/SO.xpm 
WE   ./textures/WE.xpm 
EA ./textures/EA.xpm 
S ./textures/SPRITE.xpm 
C 12     , 1, 12
F 12   ,   153   ,  144

111111111111111
100000000000001
10000200000000111111111111
100000000000000000000000001
10000000000000111111111111
100000000000001
100000000000001
10000N000000001
111111111111111
