R 800 600
NO   ./textures/NO.xpm 
SO   ./textures/SO.xpm 
WE   ./textures/WE.xpm 
EA ./textures/EA.xpm 
S ./textures/SPRITE.xpm
C 114     ,  75     ,   33
F 161   ,   153   ,  144

111111111111111
100000000000001
100200200000001
100000000000001
100002W20000001
100000200000001
100000000000001
100000000000001
111111111111111
