R 800 600
NO   ./textures/NO.xpm 
SO   ./textures/SO.xpm 
WE   ./textures/WE.xpm 
EA ./textures/EA.xpm 
S ./textures/SPRITE.xpm
C 0     ,  0     ,   0 
F 255   ,   255   ,   255

111111
1100111111111111  111111111
1000000000000001  100000001
1000011111111101  100000001
100N01       10111100000001
111111       10000000000001
111111       10000000000001
111111       10000000000001
111111       10000000000001
111111       10000000000001
111111       10000000000001
111111       100000000000011111111111
111111       10000000000001111111111111111111
111111       1000000000000111111111
             111111111111111111111
             1111111111111111111111111
             11111111111111
             11111111111111
             11111111111111
             11111111111111
             11111111111111
             11111111111111
             11111111111111
